2 8 8 8 8 8 8 8 8 8 8 8 8 8 8 8 8 8 8 8 8 8 8 17
3 9 9 10 9 9 9 9 9 9 9 9 9 9 9 9 9 9 9 9 9 9 9 18
4 0 0 11 0 0 6 7 1 1 1 1 1 1 1 1 1 1 1 1 1 1 1 19
5 0 0 12 0 0 6 7 1 1 1 1 1 1 1 1 1 1 1 1 20 21 1 1
5 0 0 0 0 0 0 0 1 1 1 1 1 1 1 1 1 1 1 1 22 23 1 1
5 0 0 0 0 0 0 0 1 1 1 1 1 1 1 1 1 1 1 1 1 1 1 1
0 0 0 0 0 0 0 0 1 1 24 26 29 31 26 29 31 26 29 31 26 33 1 1
0 0 0 0 0 0 0 0 1 1 25 27 30 32 27 30 32 27 30 32 27 34 1 1
0 0 0 0 0 0 5 5 1 1 1 28 1 1 28 1 1 28 1 1 28 1 1 1
6 7 0 0 0 0 5 5 1 1 1 1 1 1 1 1 1 1 1 1 1 1 1 1
1 1 1 1 1 1 1 1 1 1 24 26 29 31 26 29 31 26 29 31 26 33 1 1
1 1 1 1 1 1 1 1 1 1 25 27 30 32 27 30 32 27 30 32 27 34 1 1
1 1 1 1 1 1 1 1 1 1 1 28 1 1 28 1 1 28 1 1 28 1 1 1
1 1 1 1 1 1 1 1 1 1 1 1 1 1 1 1 1 1 1 1 1 1 1 1
1 1 1 1 1 1 1 1 1 1 24 26 29 31 26 29 31 26 29 31 26 33 1 1
1 1 1 1 1 1 1 1 1 1 25 27 30 32 27 30 32 27 30 32 27 34 1 1
1 1 1 1 1 1 1 1 1 1 1 28 1 1 28 1 1 28 1 1 28 1 1 1
1 1 1 1 1 1 1 1 1 1 1 1 1 1 1 1 1 1 1 1 1 1 1 1